TEAM_NAME,FGM,FGA,FG3M,FG3A,FG%,FG3%,FG2M,FG2A,2P%,SEASON
Atlanta Hawks,2876,6668,333,933,43.13137372525495,35.69131832797427,2543,5735,44.34176111595466,2000-01
Boston Celtics,2773,6485,592,1633,42.76021588280648,36.25229638701776,2181,4852,44.95053586150041,2000-01
Charlotte Hornets,2800,6501,340,984,43.07029687740347,34.552845528455286,2460,5517,44.58945078847199,2000-01
Chicago Bulls,2721,6411,329,950,42.44267664950866,34.63157894736842,2392,5461,43.80150155649149,2000-01
Cleveland Cavaliers,2890,6532,220,659,44.243723208818125,33.38391502276176,2670,5873,45.46228503320279,2000-01
Dallas Mavericks,3085,6716,517,1357,45.93508040500298,38.09874723655122,2568,5359,47.91938794551222,2000-01
Denver Nuggets,2979,6877,512,1444,43.3183074014832,35.45706371191136,2467,5433,45.40769372354132,2000-01
Detroit Pistons,2919,6880,389,1112,42.42732558139535,34.982014388489205,2530,5768,43.86269070735091,2000-01
Golden State Warriors,2937,7175,282,964,40.933797909407666,29.253112033195023,2655,6211,42.74673965545001,2000-01
Houston Rockets,2943,6494,504,1412,45.31875577456113,35.69405099150141,2439,5082,47.992916174734354,2000-01
Indiana Pacers,2828,6431,396,1159,43.97449852278028,34.167385677308026,2432,5272,46.13050075872534,2000-01
Los Angeles Clippers,2896,6467,360,1063,44.781196845523425,33.866415804327374,2536,5404,46.92820133234641,2000-01
Los Angeles Lakers,3109,6685,439,1275,46.50710545998504,34.431372549019606,2670,5410,49.35304990757856,2000-01
Miami Heat,2694,6258,478,1384,43.04889741131352,34.53757225433526,2216,4874,45.46573656134591,2000-01
Milwaukee Bucks,3112,6798,562,1481,45.77817005001471,37.94733288318704,2550,5317,47.95937558773745,2000-01
Minnesota Timberwolves,3148,6871,322,901,45.81574734390919,35.73806881243063,2826,5970,47.33668341708543,2000-01
New Jersey Nets,2781,6550,361,1084,42.458015267175576,33.30258302583026,2420,5466,44.27369191364801,2000-01
New York Knicks,2755,6198,391,1115,44.449822523394644,35.06726457399103,2364,5083,46.50796773558922,2000-01
Orlando Magic,3013,6873,490,1346,43.83820747853921,36.40416047548291,2523,5527,45.64863397865026,2000-01
Philadelphia 76ers,2902,6487,262,803,44.73562509634654,32.62764632627647,2640,5684,46.44616467276566,2000-01
Phoenix Suns,2944,6757,332,1054,43.56963149326624,31.499051233396585,2612,5703,45.8004559004033,2000-01
Portland Trail Blazers,3004,6417,369,1057,46.813152563503195,34.91012298959319,2635,5360,49.16044776119403,2000-01
Sacramento Kings,3132,6969,479,1353,44.941885492897114,35.40280857354028,2653,5616,47.24002849002849,2000-01
San Antonio Spurs,2884,6262,445,1094,46.05557329926541,40.67641681901279,2439,5168,47.19427244582043,2000-01
Seattle SuperSonics,3029,6649,466,1169,45.55572266506241,39.86313088109495,2563,5480,46.770072992700726,2000-01
Toronto Raptors,3048,6972,429,1164,43.71772805507745,36.855670103092784,2619,5808,45.09297520661157,2000-01
Utah Jazz,2960,6289,325,852,47.0663062490062,38.14553990610329,2635,5437,48.464226595549015,2000-01
Vancouver Grizzlies,2870,6539,325,947,43.89050313503594,34.31890179514255,2545,5592,45.51144492131617,2000-01
Washington Wizards,2833,6453,275,848,43.90206105687277,32.42924528301887,2558,5605,45.63782337198929,2000-01
Atlanta Hawks,2901,6610,423,1194,43.888048411497735,35.427135678391956,2478,5416,45.753323485967506,2001-02
Boston Celtics,2852,6731,699,1946,42.37111870450156,35.91983556012333,2153,4785,44.994775339602924,2001-02
Charlotte Hornets,2893,6580,346,994,43.96656534954408,34.80885311871227,2547,5586,45.59613319011815,2001-02
Chicago Bulls,2811,6491,300,868,43.30611616083808,34.56221198156682,2511,5623,44.655877645385026,2001-02
Cleveland Cavaliers,2948,6582,387,1026,44.78881798845335,37.719298245614034,2561,5556,46.0943124550036,2001-02
Dallas Mavericks,3200,6930,621,1645,46.17604617604618,37.75075987841945,2579,5285,48.79848628192999,2001-02
Denver Nuggets,2915,6870,423,1285,42.43085880640466,32.91828793774319,2492,5585,44.619516562220234,2001-02
Detroit Pistons,2845,6301,567,1509,45.15156324392953,37.57455268389662,2278,4792,47.537562604340565,2001-02
Golden State Warriors,2998,6989,320,994,42.895979396194015,32.19315895372233,2678,5995,44.67055879899917,2001-02
Houston Rockets,2837,6629,496,1480,42.79680193090964,33.513513513513516,2341,5149,45.46513886191493,2001-02
Indiana Pacers,2935,6580,405,1195,44.6048632218845,33.89121338912134,2530,5385,46.982358402971215,2001-02
Los Angeles Clippers,2970,6668,408,1147,44.54109178164367,35.571054925893634,2562,5521,46.40463684115196,2001-02
Los Angeles Lakers,3150,6840,510,1439,46.05263157894737,35.44127866574009,2640,5401,48.87983706720978,2001-02
Memphis Grizzlies,2851,6535,336,1096,43.626625860749805,30.656934306569344,2515,5439,46.240117668689095,2001-02
Miami Heat,2801,6382,312,899,43.88906298965841,34.705228031145715,2489,5483,45.39485683020244,2001-02
Milwaukee Bucks,3041,6577,593,1583,46.23688611829102,37.46051800379027,2448,4994,49.01882258710452,2001-02
Minnesota Timberwolves,3175,6887,396,1047,46.101350370262814,37.82234957020057,2779,5840,47.58561643835616,2001-02
New Jersey Nets,3042,6816,403,1194,44.63028169014084,33.75209380234506,2639,5622,46.94059053717538,2001-02
New York Knicks,2817,6520,474,1344,43.20552147239264,35.267857142857146,2343,5176,45.266615146831526,2001-02
Orlando Magic,3087,6892,620,1660,44.79106210098665,37.34939759036144,2467,5232,47.15214067278288,2001-02
Philadelphia 76ers,2804,6436,214,715,43.567433188315725,29.93006993006993,2590,5721,45.271805628386645,2001-02
Phoenix Suns,3097,6934,358,1096,44.66397461782521,32.66423357664234,2739,5838,46.91675231243577,2001-02
Portland Trail Blazers,3004,6671,466,1318,45.030730025483436,35.35660091047041,2538,5353,47.41266579488138,2001-02
Sacramento Kings,3267,7003,426,1160,46.65143509924318,36.724137931034484,2841,5843,48.62228307376348,2001-02
San Antonio Spurs,2913,6363,438,1211,45.78029231494578,36.168455821635014,2475,5152,48.03959627329192,2001-02
Seattle SuperSonics,3131,6681,489,1292,46.864241879958094,37.84829721362229,2642,5389,49.02579328261273,2001-02
Toronto Raptors,2919,6727,387,1109,43.39229968782518,34.89630297565374,2532,5618,45.069419722321115,2001-02
Utah Jazz,2869,6374,280,842,45.01098211484154,33.2541567695962,2589,5532,46.800433839479396,2001-02
Washington Wizards,2938,6664,305,786,44.087635054021604,38.80407124681934,2633,5878,44.79414766927526,2001-02
Atlanta Hawks,2859,6434,402,1141,44.43580976064656,35.232252410166524,2457,5293,46.419799735499716,2002-03
Boston Celtics,2700,6509,719,2155,41.48102627131664,33.364269141531324,1981,4354,45.4983922829582,2002-03
Chicago Bulls,2991,6714,349,997,44.548704200178726,35.00501504513541,2642,5717,46.213048801819134,2002-03
Cleveland Cavaliers,2850,6746,293,897,42.24725763415357,32.6644370122631,2557,5849,43.71687467943238,2002-03
Dallas Mavericks,3161,6982,636,1668,45.273560584359785,38.1294964028777,2525,5314,47.51599548362815,2002-03
Denver Nuggets,2689,6544,229,824,41.09107579462103,27.791262135922327,2460,5720,43.00699300699301,2002-03
Detroit Pistons,2700,6277,533,1488,43.01417874780946,35.81989247311828,2167,4789,45.24953017331384,2002-03
Golden State Warriors,3061,6941,425,1235,44.100273735772944,34.41295546558704,2636,5706,46.196985629162285,2002-03
Houston Rockets,2840,6461,439,1267,43.956043956043956,34.64877663772691,2401,5194,46.22641509433962,2002-03
Indiana Pacers,2911,6608,379,1119,44.05266343825666,33.86952636282395,2532,5489,46.128620878119875,2002-03
Los Angeles Clippers,2835,6490,390,1178,43.68258859784284,33.106960950764005,2445,5312,46.02786144578313,2002-03
Los Angeles Lakers,3091,6856,486,1367,45.08459743290548,35.55230431602048,2605,5489,47.45855347057752,2002-03
Memphis Grizzlies,3049,6743,467,1279,45.217262346136735,36.512900703674745,2582,5464,47.25475841874085,2002-03
Miami Heat,2688,6517,348,1100,41.245972073039745,31.636363636363633,2340,5417,43.1973417020491,2002-03
Milwaukee Bucks,3045,6670,585,1526,45.65217391304348,38.33551769331586,2460,5144,47.82270606531882,2002-03
Minnesota Timberwolves,3172,6809,296,804,46.58540167425466,36.81592039800995,2876,6005,47.89342214820982,2002-03
New Jersey Nets,2906,6585,346,1041,44.13059984813971,33.23727185398655,2560,5544,46.17604617604618,2002-03
New Orleans Hornets,2914,6695,404,1075,43.52501867064974,37.58139534883721,2510,5620,44.661921708185055,2002-03
New York Knicks,2967,6725,606,1582,44.118959107806695,38.305941845764856,2361,5143,45.907058137273964,2002-03
Orlando Magic,2947,6763,568,1590,43.5753363891764,35.72327044025157,2379,5173,45.9887879373671,2002-03
Philadelphia 76ers,2975,6640,245,787,44.80421686746988,31.13087674714104,2730,5853,46.64274730907227,2002-03
Phoenix Suns,3005,6776,394,1149,44.34769775678867,34.29068755439513,2611,5627,46.40127954505065,2002-03
Portland Trail Blazers,2987,6491,379,1150,46.01756277923278,32.95652173913044,2608,5341,48.829807152218685,2002-03
Sacramento Kings,3242,6990,491,1288,46.380543633762514,38.121118012422365,2751,5702,48.24622939319537,2002-03
San Antonio Spurs,2908,6297,449,1270,46.180720978243606,35.35433070866142,2459,5027,48.9158543863139,2002-03
Seattle SuperSonics,2887,6599,456,1291,43.74905288680103,35.321456235476376,2431,5308,45.79879427279578,2002-03
Toronto Raptors,2847,6664,409,1193,42.72208883553421,34.28331936295054,2438,5471,44.562237250959605,2002-03
Utah Jazz,2894,6189,224,641,46.76038132169979,34.945397815912635,2670,5548,48.125450612833454,2002-03
Washington Wizards,2816,6394,253,811,44.041288708163904,31.1960542540074,2563,5583,45.907218341393516,2002-03
Atlanta Hawks,2829,6529,419,1249,43.329759534385055,33.54683746997598,2410,5280,45.64393939393939,2003-04
Boston Celtics,2843,6415,553,1599,44.31800467653936,34.58411507191995,2290,4816,47.54983388704319,2003-04
Chicago Bulls,2798,6753,429,1256,41.433436990966975,34.15605095541402,2369,5497,43.09623430962343,2003-04
Cleveland Cavaliers,2922,6753,247,786,43.26965792980897,31.424936386768447,2675,5967,44.829897771074236,2003-04
Dallas Mavericks,3322,7230,507,1456,45.94744121715076,34.82142857142857,2815,5774,48.753030827848974,2003-04
Denver Nuggets,2993,6763,331,985,44.255507910690525,33.60406091370559,2662,5778,46.07130494980962,2003-04
Detroit Pistons,2747,6314,333,968,43.506493506493506,34.40082644628099,2414,5346,45.155256266367374,2003-04
Golden State Warriors,2875,6511,429,1283,44.15604361849178,33.43725643024162,2446,5228,46.78653404743688,2003-04
Houston Rockets,2738,6195,515,1406,44.19693301049234,36.62873399715505,2223,4789,46.418876592190436,2003-04
Indiana Pacers,2753,6322,449,1281,43.546346093008545,35.050741608118656,2304,5041,45.70521721880579,2003-04
Los Angeles Clippers,2817,6579,329,1024,42.818057455540355,32.12890625,2488,5555,44.78847884788479,2003-04
Los Angeles Lakers,3028,6676,365,1115,45.356500898741764,32.73542600896861,2663,5561,47.88707067074267,2003-04
Memphis Grizzlies,2963,6657,447,1314,44.50953883130539,34.01826484018265,2516,5343,47.08965000935804,2003-04
Miami Heat,2729,6417,485,1357,42.52766090073243,35.74060427413412,2244,5060,44.34782608695652,2003-04
Milwaukee Bucks,2970,6650,401,1145,44.661654135338345,35.02183406113537,2569,5505,46.666666666666664,2003-04
Minnesota Timberwolves,3033,6571,326,897,46.157358088570994,36.34336677814939,2707,5674,47.70884737398661,2003-04
New Jersey Nets,2813,6372,377,1123,44.146264908976775,33.57079252003562,2436,5249,46.408839779005525,2003-04
New Orleans Hornets,2772,6605,531,1666,41.96820590461771,31.872749099639858,2241,4939,45.37355740028346,2003-04
New York Knicks,2881,6513,406,1115,44.2346077076616,36.412556053811656,2475,5398,45.85031493145609,2003-04
Orlando Magic,2904,6768,429,1248,42.90780141843972,34.375,2475,5520,44.83695652173913,2003-04
Philadelphia 76ers,2682,6260,339,992,42.843450479233226,34.17338709677419,2343,5268,44.47608200455581,2003-04
Phoenix Suns,2958,6671,415,1202,44.341178234147804,34.52579034941764,2543,5469,46.49844578533553,2003-04
Portland Trail Blazers,2898,6467,381,1102,44.812123086438845,34.57350272232305,2517,5365,46.915191053122086,2003-04
Sacramento Kings,3103,6711,601,1498,46.23752048874981,40.120160213618156,2502,5213,47.995396125071935,2003-04
San Antonio Spurs,2842,6434,408,1140,44.171588436431456,35.78947368421053,2434,5294,45.97657725727238,2003-04
Seattle SuperSonics,2939,6590,723,1936,44.59787556904401,37.345041322314046,2216,4654,47.61495487752471,2003-04
Toronto Raptors,2654,6348,461,1294,41.80844360428481,35.62596599690881,2193,5054,43.391373169766524,2003-04
Utah Jazz,2690,6172,252,786,43.58392741412832,32.06106870229007,2438,5386,45.26550315633123,2003-04
Washington Wizards,2759,6557,434,1270,42.07716943724264,34.17322834645669,2325,5287,43.9757896727823,2003-04
Atlanta Hawks,2942,6672,304,973,44.0947242206235,31.243576567317575,2638,5699,46.28882260045622,2004-05
Boston Celtics,3046,6511,437,1252,46.78236829980034,34.90415335463259,2609,5259,49.61019205172086,2004-05
Charlotte Bobcats,2961,6859,320,881,43.169558244642076,36.322360953461974,2641,5978,44.17865506858481,2004-05
Chicago Bulls,2849,6592,511,1433,43.21905339805826,35.65945568736916,2338,5159,45.31886024423338,2004-05
Cleveland Cavaliers,2990,6687,300,904,44.71362344848213,33.1858407079646,2690,5783,46.51564931696351,2004-05
Dallas Mavericks,3058,6691,463,1273,45.70318338066059,36.37077769049489,2595,5418,47.89590254706534,2004-05
Denver Nuggets,3038,6615,320,940,45.925925925925924,34.04255319148936,2718,5675,47.89427312775331,2004-05
Detroit Pistons,2851,6421,363,1053,44.401183616259146,34.472934472934476,2488,5368,46.34873323397913,2004-05
Golden State Warriors,3029,7039,624,1774,43.03168063645404,35.174746335963924,2405,5265,45.67901234567901,2004-05
Houston Rockets,2846,6419,553,1521,44.337124162642155,36.357659434582516,2293,4898,46.815026541445484,2004-05
Indiana Pacers,2668,6169,542,1575,43.24850056735289,34.41269841269841,2126,4594,46.27775359164127,2004-05
Los Angeles Clippers,2924,6368,231,669,45.91708542713568,34.52914798206278,2693,5699,47.25390419371819,2004-05
Los Angeles Lakers,2895,6629,644,1813,43.6717453612913,35.521235521235525,2251,4816,46.74003322259136,2004-05
Memphis Grizzlies,2802,6271,531,1486,44.68186892042736,35.73351278600269,2271,4785,47.460815047021946,2004-05
Miami Heat,3097,6368,475,1260,48.63379396984925,37.698412698412696,2622,5108,51.331245105716526,2004-05
Milwaukee Bucks,2964,6580,325,925,45.045592705167174,35.13513513513514,2639,5655,46.666666666666664,2004-05
Minnesota Timberwolves,3045,6629,395,1145,45.934530095036955,34.49781659388647,2650,5484,48.32239241429613,2004-05
New Jersey Nets,2753,6419,435,1203,42.88830035831126,36.15960099750624,2318,5216,44.440184049079754,2004-05
New Orleans Hornets,2718,6556,415,1316,41.458206223306895,31.534954407294833,2303,5240,43.95038167938931,2004-05
New York Knicks,2978,6599,441,1240,45.12804970450068,35.564516129032256,2537,5359,47.340921813771224,2004-05
Orlando Magic,3034,6679,320,916,45.42596197035485,34.93449781659388,2714,5763,47.09352767655735,2004-05
Philadelphia 76ers,2946,6736,505,1453,43.735154394299286,34.75567790777701,2441,5283,46.204807874313836,2004-05
Phoenix Suns,3351,7018,796,2026,47.748646337988035,39.28923988153998,2555,4992,51.18189102564102,2004-05
Portland Trail Blazers,2896,6422,420,1161,45.09498598567425,36.17571059431525,2476,5261,47.06329595134005,2004-05
Sacramento Kings,3203,6978,522,1396,45.90140441387217,37.392550143266476,2681,5582,48.029380150483696,2004-05
San Antonio Spurs,2923,6450,507,1395,45.31782945736434,36.344086021505376,2416,5055,47.7942631058358,2004-05
Seattle SuperSonics,2882,6498,666,1824,44.35210834102801,36.51315789473684,2216,4674,47.4112109542148,2004-05
Toronto Raptors,2952,6656,648,1681,44.35096153846153,38.54848304580607,2304,4975,46.311557788944725,2004-05
Utah Jazz,2828,6301,250,762,44.88176479923822,32.808398950131235,2578,5539,46.54269723776855,2004-05
Washington Wizards,2966,6794,514,1498,43.65616720635855,34.31241655540721,2452,5296,46.299093655589125,2004-05
Atlanta Hawks,2946,6496,424,1154,45.350985221674875,36.741767764298096,2522,5342,47.21078247847249,2005-06
Boston Celtics,2951,6322,467,1290,46.678266371401456,36.201550387596896,2484,5032,49.36406995230524,2005-06
Charlotte Bobcats,2961,6843,428,1261,43.27049539675581,33.94131641554322,2533,5582,45.378000716589035,2005-06
Chicago Bulls,3004,6737,560,1477,44.58957993172035,37.91469194312796,2444,5260,46.4638783269962,2005-06
Cleveland Cavaliers,2908,6412,497,1465,45.35246412975671,33.92491467576792,2411,4947,48.736608045279965,2005-06
Dallas Mavericks,2948,6375,416,1113,46.24313725490196,37.37646001796946,2532,5262,48.118586088939566,2005-06
Denver Nuggets,3078,6672,350,1076,46.13309352517986,32.52788104089219,2728,5596,48.74910650464618,2005-06
Detroit Pistons,2983,6558,557,1451,45.48642878926502,38.38731909028256,2426,5107,47.50342666927746,2005-06
Golden State Warriors,2939,6785,625,1832,43.31613854089904,34.11572052401747,2314,4953,46.71916010498688,2005-06
Houston Rockets,2708,6252,469,1414,43.31413947536788,33.16831683168317,2239,4838,46.27945431996693,2005-06
Indiana Pacers,2786,6274,536,1536,44.405482945489325,34.89583333333333,2250,4738,47.48839172646686,2005-06
Los Angeles Clippers,2993,6443,290,843,46.45351544311656,34.400948991696325,2703,5600,48.26785714285714,2005-06
Los Angeles Lakers,2992,6607,552,1583,45.285303466020885,34.870499052432095,2440,5024,48.56687898089172,2005-06
Memphis Grizzlies,2746,6125,590,1578,44.83265306122449,37.38910012674271,2156,4547,47.415878601275566,2005-06
Miami Heat,3039,6355,497,1441,47.82061369000787,34.489937543372655,2542,4914,51.729751729751726,2005-06
Milwaukee Bucks,2976,6566,507,1335,45.32439841608285,37.97752808988764,2469,5231,47.19938826228255,2005-06
Minnesota Timberwolves,2888,6340,310,942,45.55205047318612,32.90870488322717,2578,5398,47.75842904779548,2005-06
New Jersey Nets,2778,6317,477,1447,43.97657115719487,32.96475466482377,2301,4870,47.24845995893224,2005-06
New Orleans/Oklahoma City Hornets,2831,6428,300,885,44.04169259489733,33.89830508474576,2531,5543,45.661194299116005,2005-06
New York Knicks,2822,6205,320,884,45.47945205479452,36.199095022624434,2502,5321,47.02123660965984,2005-06
Orlando Magic,2911,6167,299,796,47.2028538997892,37.562814070351756,2612,5371,48.63153975051201,2005-06
Philadelphia 76ers,3001,6546,375,1031,45.84479071188512,36.37245392822502,2626,5515,47.615593834995465,2005-06
Phoenix Suns,3430,7167,837,2097,47.85823915166736,39.91416309012876,2593,5070,51.1439842209073,2005-06
Portland Trail Blazers,2791,6267,364,1042,44.53486516674645,34.93282149712092,2427,5225,46.44976076555024,2005-06
Sacramento Kings,2954,6500,494,1408,45.44615384615385,35.08522727272727,2460,5092,48.31107619795758,2005-06
San Antonio Spurs,2993,6342,524,1362,47.19331441185746,38.47283406754772,2469,4980,49.57831325301205,2005-06
Seattle SuperSonics,3077,6711,605,1631,45.85009685590821,37.09380748007358,2472,5080,48.661417322834644,2005-06
Toronto Raptors,3013,6639,608,1620,45.38334086458804,37.53086419753087,2405,5019,47.91791193464834,2005-06
Utah Jazz,2744,6207,311,925,44.20815208635412,33.62162162162162,2433,5282,46.062097690268835,2005-06
Washington Wizards,2975,6656,497,1394,44.69651442307692,35.65279770444763,2478,5262,47.092360319270234,2005-06
Atlanta Hawks,2831,6372,341,1038,44.42875078468298,32.85163776493256,2490,5334,46.681664791901014,2006-07
Boston Celtics,2858,6454,471,1283,44.28261543229005,36.710833982852684,2387,5171,46.16128408431638,2006-07
Charlotte Bobcats,2960,6643,457,1280,44.55818154448291,35.703125,2503,5363,46.6716390080179,2006-07
Chicago Bulls,3046,6663,480,1237,45.71514332883086,38.80355699272433,2566,5426,47.290821968300776,2006-07
Cleveland Cavaliers,2978,6658,494,1404,44.72814659056773,35.18518518518518,2484,5254,47.27826417967263,2006-07
Dallas Mavericks,3010,6442,535,1404,46.724619683328164,38.105413105413106,2475,5038,49.12663755458515,2006-07
Denver Nuggets,3164,6805,484,1440,46.495224099926524,33.611111111111114,2680,5365,49.95340167753961,2006-07
Detroit Pistons,2942,6484,449,1305,45.37322640345466,34.406130268199234,2493,5179,48.136705927785286,2006-07
Golden State Warriors,3261,7048,700,1966,46.268444948921676,35.60528992878942,2561,5082,50.39354584809131,2006-07
Houston Rockets,2906,6528,705,1893,44.51593137254902,37.24247226624406,2201,4635,47.48651564185545,2006-07
Indiana Pacers,2872,6561,481,1389,43.77381496723061,34.62922966162707,2391,5172,46.22969837587007,2006-07
Los Angeles Clippers,2880,6318,314,903,45.58404558404558,34.772978959025465,2566,5415,47.38688827331487,2006-07
Los Angeles Lakers,3103,6664,608,1724,46.563625450180076,35.266821345707655,2495,4940,50.506072874493924,2006-07
Memphis Grizzlies,2998,6448,500,1362,46.49503722084367,36.71071953010279,2498,5086,49.115218246165945,2006-07
Miami Heat,2919,6288,528,1539,46.42175572519084,34.30799220272904,2391,4749,50.347441566645614,2006-07
Milwaukee Bucks,3121,6714,524,1472,46.48495680667262,35.59782608695652,2597,5242,49.542159481114076,2006-07
Minnesota Timberwolves,2997,6502,384,1089,46.09350968932636,35.26170798898072,2613,5413,48.27267688897099,2006-07
New Jersey Nets,2913,6379,609,1676,45.66546480639599,36.33651551312649,2304,4703,48.99000637890708,2006-07
New Orleans/Oklahoma City Hornets,2971,6674,455,1256,44.51603236439916,36.22611464968153,2516,5418,46.43779992617202,2006-07
New York Knicks,2903,6356,474,1370,45.67337948395217,34.5985401459854,2429,4986,48.71640593662254,2006-07
Orlando Magic,2875,6090,342,962,47.20853858784893,35.550935550935556,2533,5128,49.39547581903276,2006-07
Philadelphia 76ers,2932,6408,284,823,45.75530586766542,34.50789793438639,2648,5585,47.41271262309758,2006-07
Phoenix Suns,3388,6855,785,1965,49.42377826404085,39.94910941475827,2603,4890,53.23108384458077,2006-07
Portland Trail Blazers,2874,6392,426,1232,44.96245306633291,34.57792207792208,2448,5160,47.44186046511628,2006-07
Sacramento Kings,2941,6532,530,1513,45.024494794856096,35.029742233972236,2411,5019,48.03745766088862,2006-07
San Antonio Spurs,2999,6328,595,1561,47.39254108723136,38.11659192825112,2404,4767,50.43003985735264,2006-07
Seattle SuperSonics,3047,6628,525,1451,45.97163548581774,36.18194348725017,2522,5177,48.71547228124397,2006-07
Toronto Raptors,3032,6547,531,1464,46.311287612647014,36.27049180327869,2501,5083,49.2032264410781,2006-07
Utah Jazz,3069,6471,354,1056,47.426981919332405,33.52272727272727,2715,5415,50.13850415512465,2006-07
Washington Wizards,3070,6820,561,1614,45.01466275659824,34.75836431226766,2509,5206,48.194391087207066,2006-07
Atlanta Hawks,2975,6552,384,1078,45.4059829059829,35.621521335807046,2591,5474,47.33284618195104,2007-08
Boston Celtics,2986,6286,596,1564,47.50238625517022,38.107416879795394,2390,4722,50.614146548072846,2007-08
Charlotte Bobcats,2960,6554,529,1443,45.16325907842539,36.65973665973666,2431,5111,47.56407747994522,2007-08
Chicago Bulls,2987,6861,474,1305,43.5359277073313,36.321839080459775,2513,5556,45.230381569474446,2007-08
Cleveland Cavaliers,2937,6697,552,1544,43.85545766761236,35.751295336787564,2385,5153,46.28371822239472,2007-08
Dallas Mavericks,3025,6515,494,1403,46.43131235610131,35.21026372059872,2531,5112,49.51095461658842,2007-08
Denver Nuggets,3307,7038,569,1605,46.987780619494174,35.45171339563863,2738,5433,50.39572979937419,2007-08
Detroit Pistons,2999,6551,487,1330,45.77927034040605,36.61654135338346,2512,5221,48.113388239800805,2007-08
Golden State Warriors,3403,7406,761,2185,45.94923035376722,34.828375286041194,2642,5221,50.603332694886035,2007-08
Houston Rockets,3003,6698,583,1707,44.83427888922066,34.153485647334506,2420,4991,48.487277098777795,2007-08
Indiana Pacers,3102,6993,755,2021,44.35864435864436,37.35774369124196,2347,4972,47.204344328238136,2007-08
Los Angeles Clippers,2820,6445,350,1079,43.75484871993794,32.437442075996294,2470,5366,46.03056280283265,2007-08
Los Angeles Lakers,3248,6818,662,1751,47.63860369609856,37.806967447173044,2586,5067,51.03611604499704,2007-08
Memphis Grizzlies,3060,6737,620,1779,45.42081044975508,34.85103991006183,2440,4958,49.213392496974585,2007-08
Miami Heat,2808,6336,491,1373,44.31818181818182,35.76110706482156,2317,4963,46.685472496473906,2007-08
Milwaukee Bucks,3026,6745,452,1313,44.86286137879911,34.424980959634425,2574,5432,47.38586156111929,2007-08
Minnesota Timberwolves,3076,6817,441,1259,45.1224878979023,35.02779984114376,2635,5558,47.4091399784095,2007-08
New Jersey Nets,2856,6450,498,1430,44.27906976744186,34.82517482517483,2358,5020,46.97211155378486,2007-08
New Orleans Hornets,3164,6796,630,1621,46.55679811653914,38.864898210980876,2534,5175,48.96618357487923,2007-08
New York Knicks,2967,6757,490,1454,43.91001923930739,33.70013755158185,2477,5303,46.709409768055814,2007-08
Orlando Magic,3058,6446,801,2074,47.44027303754266,38.62102217936355,2257,4372,51.62397072278133,2007-08
Philadelphia 76ers,3056,6648,302,952,45.96871239470517,31.72268907563025,2754,5696,48.3497191011236,2007-08
Phoenix Suns,3392,6782,694,1764,50.01474491300502,39.342403628117914,2698,5018,53.76644081307293,2007-08
Portland Trail Blazers,2935,6546,538,1426,44.836541399327835,37.727910238429175,2397,5120,46.81640625,2007-08
Sacramento Kings,3043,6558,510,1367,46.40134187252211,37.30797366495977,2533,5191,48.795993064920054,2007-08
San Antonio Spurs,2938,6424,594,1610,45.734744707347446,36.8944099378882,2344,4814,48.69131699210635,2007-08
Seattle SuperSonics,3125,7032,313,939,44.43970420932878,33.33333333333333,2812,6093,46.151321188248815,2007-08
Toronto Raptors,3148,6726,572,1459,46.80344930121915,39.204934886908845,2576,5267,48.90829694323144,2007-08
Utah Jazz,3279,6592,407,1095,49.74211165048544,37.1689497716895,2872,5497,52.246680007276694,2007-08
Washington Wizards,2986,6695,575,1614,44.60044809559373,35.62577447335812,2411,5081,47.451289116315685,2007-08
Atlanta Hawks,2956,6451,597,1633,45.82235312354674,36.55848132271892,2359,4818,48.96222498962225,2008-09
Boston Celtics,3075,6333,538,1355,48.55518711511132,39.70479704797048,2537,4978,50.96424266773805,2008-09
Charlotte Bobcats,2866,6299,490,1339,45.499285600889024,36.59447348767737,2376,4960,47.90322580645161,2008-09
Chicago Bulls,3126,6846,493,1293,45.661700262927255,38.12838360402166,2633,5553,47.41581127318567,2008-09
Cleveland Cavaliers,3022,6454,656,1670,46.82367524016114,39.2814371257485,2366,4784,49.45652173913043,2008-09
Dallas Mavericks,3128,6770,571,1632,46.203840472673555,34.98774509803921,2557,5138,49.76644608797197,2008-09
Denver Nuggets,3058,6510,548,1477,46.97388632872504,37.10223425863236,2510,5033,49.87085237432943,2008-09
Detroit Pistons,2981,6559,377,1079,45.44900137216039,34.93975903614458,2604,5480,47.51824817518248,2008-09
Golden State Warriors,3231,7055,550,1475,45.79730687455705,37.28813559322034,2681,5580,48.04659498207886,2008-09
Houston Rockets,2959,6526,621,1656,45.34171008274594,37.5,2338,4870,48.0082135523614,2008-09
Indiana Pacers,3220,7080,652,1725,45.48022598870056,37.79710144927536,2568,5355,47.95518207282913,2008-09
Los Angeles Clippers,2955,6696,535,1513,44.13082437275986,35.36021150033047,2420,5183,46.69110553733359,2008-09
Los Angeles Lakers,3307,6981,547,1516,47.37143675691161,36.08179419525066,2760,5465,50.503202195791395,2008-09
Memphis Grizzlies,2865,6311,398,1106,45.39692600221834,35.98553345388788,2467,5205,47.39673390970221,2008-09
Miami Heat,3034,6646,582,1631,45.65151971110442,35.683629675045985,2452,5015,48.893320039880365,2008-09
Milwaukee Bucks,3009,6755,511,1408,44.54478164322724,36.29261363636363,2498,5347,46.717785674209836,2008-09
Minnesota Timberwolves,2986,6766,543,1539,44.132426840082765,35.28265107212476,2443,5227,46.73809068299216,2008-09
New Jersey Nets,2925,6536,652,1735,44.75214198286414,37.5792507204611,2273,4801,47.34430327015205,2008-09
New Orleans Hornets,2911,6366,556,1526,45.72730128809299,36.435124508519,2355,4840,48.65702479338843,2008-09
New York Knicks,3157,7091,823,2284,44.52122408687068,36.03327495621716,2334,4807,48.55419180361972,2008-09
Oklahoma City Thunder,2999,6716,328,949,44.65455628350208,34.562697576396204,2671,5767,46.31524189353217,2008-09
Orlando Magic,2929,6416,817,2147,45.65149625935162,38.05309734513274,2112,4269,49.47294448348559,2008-09
Philadelphia 76ers,2997,6532,341,1072,45.88181261481935,31.80970149253731,2656,5460,48.64468864468864,2008-09
Phoenix Suns,3373,6695,553,1445,50.38088125466766,38.26989619377162,2820,5250,53.714285714285715,2008-09
Portland Trail Blazers,3018,6494,596,1555,46.47366800123191,38.327974276527335,2422,4939,49.038266855638796,2008-09
Sacramento Kings,2990,6685,586,1594,44.72700074794316,36.762860727728985,2404,5091,47.220585346690235,2008-09
San Antonio Spurs,3042,6534,625,1620,46.5564738292011,38.58024691358025,2417,4914,49.18599918599919,2008-09
Toronto Raptors,3054,6673,479,1289,45.76652180428592,37.16058960434445,2575,5384,47.826894502228825,2008-09
Utah Jazz,3143,6623,392,1122,47.45583572399215,34.93761140819964,2751,5501,50.00908925649882,2008-09
Washington Wizards,2994,6655,395,1198,44.98873027798648,32.97161936560935,2599,5457,47.626901227780834,2008-09
Atlanta Hawks,3181,6801,524,1455,46.772533450963095,36.013745704467354,2657,5346,49.70071081182192,2009-10
Boston Celtics,3039,6294,499,1433,48.28408007626311,34.82205163991626,2540,4861,52.25262291709525,2009-10
Charlotte Bobcats,2858,6306,460,1331,45.321915635902315,34.56048084147258,2398,4975,48.201005025125625,2009-10
Chicago Bulls,3081,6825,352,1066,45.14285714285714,33.02063789868668,2729,5759,47.38669907970134,2009-10
Cleveland Cavaliers,3101,6391,602,1582,48.521358159912374,38.05309734513274,2499,4809,51.96506550218341,2009-10
Dallas Mavericks,3140,6760,558,1498,46.44970414201183,37.24966622162884,2582,5262,49.06879513492968,2009-10
Denver Nuggets,3124,6678,544,1517,46.78047319556754,35.86025049439684,2580,5161,49.990311955047474,2009-10
Detroit Pistons,2940,6602,374,1190,44.53196001211754,31.428571428571427,2566,5412,47.413155949741316,2009-10
Golden State Warriors,3329,7094,633,1687,46.926980546941074,37.522228808535864,2696,5407,49.86129091917884,2009-10
Houston Rockets,3094,6923,646,1838,44.69160768452983,35.14689880304679,2448,5085,48.14159292035398,2009-10
Indiana Pacers,3020,6823,659,1896,44.26205481459768,34.757383966244724,2361,4927,47.91962654759489,2009-10
Los Angeles Clippers,3002,6601,483,1457,45.47795788516891,33.15030885380919,2519,5144,48.969673405909795,2009-10
Los Angeles Lakers,3144,6875,532,1562,45.73090909090909,34.05889884763124,2612,5313,49.16243177112742,2009-10
Memphis Grizzlies,3223,6875,344,1020,46.88,33.72549019607843,2879,5855,49.17164816396242,2009-10
Miami Heat,2984,6518,494,1426,45.78091439091746,34.642356241234225,2490,5092,48.900235663786326,2009-10
Milwaukee Bucks,3050,6998,645,1813,43.58388110888826,35.57639271924986,2405,5185,46.38379942140791,2009-10
Minnesota Timberwolves,3106,6923,403,1181,44.86494294381049,34.123624047417444,2703,5742,47.07419017763846,2009-10
New Jersey Nets,2813,6554,377,1185,42.92035398230089,31.814345991561183,2436,5369,45.371577574967404,2009-10
New Orleans Hornets,3178,6842,571,1572,46.44840689856767,36.32315521628499,2607,5270,49.46869070208729,2009-10
New York Knicks,3127,6876,743,2145,45.47702152414194,34.63869463869464,2384,4731,50.39103783555273,2009-10
Oklahoma City Thunder,3063,6629,418,1229,46.20606426308644,34.01139137510171,2645,5400,48.98148148148148,2009-10
Orlando Magic,3005,6394,841,2241,46.997184860807,37.52788933511825,2164,4153,52.106910666987716,2009-10
Philadelphia 76ers,3087,6706,474,1381,46.03340292275574,34.32295438088342,2613,5325,49.070422535211264,2009-10
Phoenix Suns,3339,6788,730,1770,49.18974661166765,41.24293785310734,2609,5018,51.99282582702271,2009-10
Portland Trail Blazers,2974,6453,491,1388,46.0870912753758,35.37463976945245,2483,5065,49.02270483711747,2009-10
Sacramento Kings,3144,6895,482,1383,45.598259608411894,34.85177151120752,2662,5512,48.294629898403485,2009-10
San Antonio Spurs,3150,6659,554,1547,47.30440006006908,35.81124757595346,2596,5112,50.78247261345853,2009-10
Toronto Raptors,3199,6631,518,1397,48.24310058814659,37.07945597709377,2681,5234,51.22277416889568,2009-10
Utah Jazz,3227,6575,439,1207,49.07984790874524,36.37116818558409,2788,5368,51.93740685543964,2009-10
Washington Wizards,3008,6700,432,1225,44.8955223880597,35.26530612244898,2576,5475,47.050228310502284,2009-10
Atlanta Hawks,2971,6429,502,1427,46.21247472390729,35.17869656622285,2469,5002,49.36025589764094,2010-11
Boston Celtics,3023,6219,408,1119,48.60910114166265,36.46112600536193,2615,5100,51.27450980392156,2010-11
Charlotte Bobcats,2873,6365,393,1203,45.13747054202671,32.66832917705736,2480,5162,48.04339403332042,2010-11
Chicago Bulls,3042,6587,511,1415,46.181873386974345,36.113074204947,2531,5172,48.93658159319412,2010-11
Cleveland Cavaliers,2886,6647,509,1489,43.418083345870315,34.184016118200134,2377,5158,46.083753392787905,2010-11
Dallas Mavericks,3069,6463,645,1768,47.48568776110166,36.48190045248869,2424,4695,51.629392971246006,2010-11
Denver Nuggets,3145,6613,662,1704,47.55784061696658,38.84976525821596,2483,4909,50.58056630678346,2010-11
Detroit Pistons,3056,6647,472,1256,45.97562810290356,37.57961783439491,2584,5391,47.9317380819885,2010-11
Golden State Warriors,3251,7047,685,1749,46.13310628636299,39.16523727844483,2566,5298,48.43337108342771,2010-11
Houston Rockets,3170,6975,677,1843,45.448028673835125,36.73358654367879,2493,5132,48.57755261106781,2010-11
Indiana Pacers,3003,6787,585,1653,44.246353322528364,35.39019963702359,2418,5134,47.097779509154655,2010-11
Los Angeles Clippers,3015,6594,513,1519,45.72338489535942,33.77221856484529,2502,5075,49.30049261083744,2010-11
Los Angeles Lakers,3128,6757,524,1487,46.29273346159538,35.23873570948218,2604,5270,49.411764705882355,2010-11
Memphis Grizzlies,3200,6801,309,926,47.05190413174533,33.36933045356372,2891,5875,49.20851063829787,2010-11
Miami Heat,3031,6301,547,1479,48.10347563878749,36.984448951994594,2484,4822,51.51389464952302,2010-11
Milwaukee Bucks,2814,6544,483,1414,43.00122249388753,34.15841584158416,2331,5130,45.438596491228076,2010-11
Minnesota Timberwolves,3090,7014,589,1565,44.05474764756202,37.635782747603834,2501,5449,45.89832996880162,2010-11
New Jersey Nets,2918,6638,459,1337,43.9590238023501,34.33059087509349,2459,5301,46.38747406149783,2010-11
New Orleans Hornets,2944,6416,444,1232,45.885286783042396,36.038961038961034,2500,5184,48.2253086419753,2010-11
New York Knicks,3140,6867,765,2081,45.72593563419252,36.7611725132148,2375,4786,49.623903050564145,2010-11
Oklahoma City Thunder,3066,6609,487,1403,46.39128461189287,34.71133285816108,2579,5206,49.53899346907414,2010-11
Orlando Magic,2956,6411,770,2103,46.10825144283263,36.614360437470275,2186,4308,50.74280408542246,2010-11
Philadelphia 76ers,3125,6776,443,1248,46.11865407319953,35.496794871794876,2682,5528,48.516642547033285,2010-11
Phoenix Suns,3219,6844,701,1857,47.03389830508475,37.74905761981691,2518,4987,50.49127732103469,2010-11
Portland Trail Blazers,2951,6599,518,1503,44.718896802545835,34.46440452428477,2433,5096,47.743328100470954,2010-11
Sacramento Kings,3134,6979,428,1277,44.90614701246597,33.51605324980423,2706,5702,47.45703262013329,2010-11
San Antonio Spurs,3148,6628,685,1727,47.495473747736874,39.664157498552406,2463,4901,50.255049989797996,2010-11
Toronto Raptors,3144,6755,345,1091,46.54330125832716,31.622364802933088,2799,5664,49.41737288135593,2010-11
Utah Jazz,3064,6590,435,1256,46.49468892261002,34.63375796178344,2629,5334,49.28758905136858,2010-11
Washington Wizards,3048,6888,392,1182,44.25087108013937,33.16412859560068,2656,5706,46.54749386610585,2010-11
Atlanta Hawks,2429,5348,492,1330,45.41884816753927,36.99248120300752,1937,4018,48.208063713290194,2011-12
Boston Celtics,2341,5086,363,988,46.02831301612269,36.74089068825911,1978,4098,48.26744753538311,2011-12
Charlotte Bobcats,2193,5293,263,892,41.43208010580011,29.484304932735427,1930,4401,43.853669620540785,2011-12
Chicago Bulls,2467,5462,419,1117,45.16660563896009,37.51119068934646,2048,4345,47.134637514384345,2011-12
Cleveland Cavaliers,2261,5360,440,1273,42.18283582089552,34.56402199528672,1821,4087,44.55590897969171,2011-12
Dallas Mavericks,2398,5412,497,1464,44.3089430894309,33.94808743169399,1901,3948,48.15096251266464,2011-12
Denver Nuggets,2572,5404,435,1311,47.59437453737972,33.18077803203661,2137,4093,52.211092108477885,2011-12
Detroit Pistons,2291,5232,317,916,43.78822629969419,34.60698689956332,1974,4316,45.73679332715477,2011-12
Golden State Warriors,2489,5443,524,1351,45.72845857064119,38.786084381939304,1965,4092,48.02052785923754,2011-12
Houston Rockets,2489,5543,478,1330,44.90348186902399,35.93984962406015,2011,4213,47.73320674103964,2011-12
Indiana Pacers,2354,5375,392,1064,43.7953488372093,36.84210526315789,1962,4311,45.51148225469729,2011-12
Los Angeles Clippers,2439,5366,514,1441,45.452851285874026,35.66967383761277,1925,3925,49.044585987261144,2011-12
Los Angeles Lakers,2429,5319,362,1112,45.66647866140252,32.55395683453237,2067,4207,49.132398383646304,2011-12
Memphis Grizzlies,2425,5422,277,849,44.72519365547768,32.6266195524146,2148,4573,46.97135359720096,2011-12
Miami Heat,2446,5212,370,1030,46.93016116653876,35.92233009708738,2076,4182,49.64131994261119,2011-12
Milwaukee Bucks,2502,5652,436,1265,44.26751592356688,34.466403162055336,2066,4387,47.093685890129926,2011-12
Minnesota Timberwolves,2355,5434,473,1423,43.33824070666176,33.23963457484188,1882,4011,46.920967339815505,2011-12
New Jersey Nets,2262,5320,507,1481,42.5187969924812,34.23362592842673,1755,3839,45.71502995571763,2011-12
New Orleans Hornets,2300,5103,259,777,45.071526553008034,33.33333333333333,2041,4326,47.17984281091077,2011-12
New York Knicks,2365,5335,517,1538,44.329896907216494,33.61508452535761,1848,3797,48.67000263365815,2011-12
Oklahoma City Thunder,2462,5229,472,1317,47.083572384777206,35.83902809415338,1990,3912,50.869120654396724,2011-12
Orlando Magic,2275,5162,670,1785,44.072065091049986,37.53501400560224,1605,3377,47.52739117559964,2011-12
Philadelphia 76ers,2471,5516,349,963,44.79695431472081,36.24091381100727,2122,4553,46.606632989237866,2011-12
Phoenix Suns,2495,5445,444,1295,45.821854912764,34.285714285714285,2051,4150,49.42168674698795,2011-12
Portland Trail Blazers,2402,5417,478,1382,44.34188665312904,34.58755426917511,1924,4035,47.68277571251549,2011-12
Sacramento Kings,2490,5712,411,1301,43.59243697478992,31.59108378170638,2079,4411,47.13216957605985,2011-12
San Antonio Spurs,2611,5463,552,1405,47.79425224235768,39.288256227758005,2059,4058,50.73928043371119,2011-12
Toronto Raptors,2268,5154,365,1075,44.0046565774156,33.95348837209302,1903,4079,46.65359156656043,2011-12
Utah Jazz,2523,5531,273,845,45.61562104501898,32.30769230769231,2250,4686,48.015364916773365,2011-12
Washington Wizards,2414,5475,344,1075,44.09132420091324,32.0,2070,4400,47.04545454545455,2011-12
Atlanta Hawks,3084,6644,706,1901,46.41782059000602,37.1383482377696,2378,4743,50.13704406493781,2012-13
Boston Celtics,3001,6459,498,1390,46.46230066573773,35.827338129496404,2503,5069,49.37857565594792,2012-13
Brooklyn Nets,2942,6544,628,1760,44.95721271393643,35.68181818181818,2314,4784,48.369565217391305,2012-13
Charlotte Bobcats,2823,6649,469,1399,42.457512407880884,33.52394567548249,2354,5250,44.838095238095235,2012-13
Chicago Bulls,2926,6698,446,1265,43.684681994625265,35.25691699604743,2480,5433,45.64697220688386,2012-13
Cleveland Cavaliers,2993,6901,547,1581,43.37052601072308,34.59835547122075,2446,5320,45.97744360902256,2012-13
Dallas Mavericks,3182,6892,606,1628,46.16947185142194,37.223587223587224,2576,5264,48.93617021276596,2012-13
Denver Nuggets,3339,6983,521,1518,47.81612487469569,34.32147562582345,2818,5465,51.56450137236962,2012-13
Detroit Pistons,2979,6638,513,1440,44.877975293763186,35.625,2466,5198,47.44132358599462,2012-13
Golden State Warriors,3130,6840,658,1632,45.760233918128655,40.318627450980394,2472,5208,47.465437788018434,2012-13
Houston Rockets,3124,6782,867,2369,46.06310822766146,36.59772055719713,2257,4413,51.14434624971674,2012-13
Indiana Pacers,2845,6525,555,1599,43.60153256704981,34.709193245778614,2290,4926,46.4880227365002,2012-13
Los Angeles Clippers,3160,6608,627,1752,47.82082324455206,35.78767123287671,2533,4856,52.162273476112034,2012-13
Los Angeles Lakers,3041,6640,715,2015,45.79819277108434,35.483870967741936,2326,4625,50.29189189189189,2012-13
Memphis Grizzlies,2964,6679,382,1107,44.377900883365776,34.507678410117435,2582,5572,46.33883704235463,2012-13
Miami Heat,3148,6348,717,1809,49.59042218021424,39.63515754560531,2431,4539,53.558052434456926,2012-13
Milwaukee Bucks,3128,7197,601,1670,43.46255384187856,35.98802395209581,2527,5527,45.72100597068934,2012-13
Minnesota Timberwolves,2943,6702,450,1475,43.91226499552373,30.508474576271187,2493,5227,47.69466233020853,2012-13
New Orleans Hornets,2955,6589,535,1474,44.847473061162546,36.29579375848033,2420,5115,47.31182795698925,2012-13
New York Knicks,2996,6689,891,2371,44.78995365525489,37.57908055672712,2105,4318,48.74942102825382,2012-13
Oklahoma City Thunder,3126,6504,598,1588,48.06273062730627,37.657430730478595,2528,4916,51.42392188771359,2012-13
Orlando Magic,3093,6904,506,1537,44.80011587485516,32.921275211450876,2587,5367,48.20197503260667,2012-13
Philadelphia 76ers,3059,6895,518,1438,44.36548223350254,36.02225312934632,2541,5457,46.56404617921935,2012-13
Phoenix Suns,3061,6917,480,1455,44.253288998120574,32.98969072164948,2581,5462,47.253753203954595,2012-13
Portland Trail Blazers,3009,6715,673,1904,44.81012658227848,35.346638655462186,2336,4811,48.555393889004364,2012-13
Sacramento Kings,3086,6904,610,1681,44.69872537659328,36.2879238548483,2476,5223,47.40570553321846,2012-13
San Antonio Spurs,3210,6675,663,1764,48.08988764044943,37.58503401360544,2547,4911,51.86316432498472,2012-13
Toronto Raptors,2979,6685,571,1665,44.56245325355273,34.29429429429429,2408,5020,47.96812749003984,2012-13
Utah Jazz,3046,6710,507,1385,45.39493293591654,36.60649819494585,2539,5325,47.68075117370892,2012-13
Washington Wizards,2910,6693,545,1495,43.47826086956522,36.45484949832776,2365,5198,45.49826856483263,2012-13
Atlanta Hawks,3061,6688,768,2116,45.76854066985646,36.29489603024575,2293,4572,50.15310586176728,2013-14
Boston Celtics,2996,6883,575,1729,43.5275315995932,33.256217466743784,2421,5154,46.9732246798603,2013-14
Brooklyn Nets,2931,6391,709,1922,45.861367548114536,36.88865764828304,2222,4469,49.72029536809129,2013-14
Charlotte Bobcats,2976,6730,516,1471,44.21991084695394,35.078178110129166,2460,5259,46.77695379349686,2013-14
Chicago Bulls,2843,6577,508,1459,43.226395012923824,34.81836874571624,2335,5118,45.62329034779211,2013-14
Cleveland Cavaliers,3036,6955,584,1640,43.652048885693745,35.609756097560975,2452,5315,46.133584195672626,2013-14
Dallas Mavericks,3249,6858,721,1877,47.3753280839895,38.41236014917421,2528,4981,50.75286087131098,2013-14
Denver Nuggets,3147,7042,702,1959,44.689008804316956,35.83460949464013,2445,5083,48.10151485343302,2013-14
Detroit Pistons,3182,7124,507,1580,44.66591802358226,32.08860759493671,2675,5544,48.25036075036075,2013-14
Golden State Warriors,3236,7005,774,2037,46.195574589578875,37.99705449189985,2462,4968,49.55716586151369,2013-14
Houston Rockets,3118,6603,779,2179,47.22096016961987,35.75034419458467,2339,4424,52.87070524412296,2013-14
Indiana Pacers,2949,6573,550,1542,44.86535828388863,35.66796368352789,2399,5031,47.684356986682566,2013-14
Los Angeles Clippers,3208,6761,693,1966,47.44860227776956,35.24923702950152,2515,4795,52.45046923879041,2013-14
Los Angeles Lakers,3139,6980,774,2032,44.97134670487106,38.09055118110236,2365,4948,47.79708973322555,2013-14
Memphis Grizzlies,3122,6723,405,1147,46.43760226089543,35.30950305143853,2717,5576,48.72668579626973,2013-14
Miami Heat,3142,6272,665,1829,50.09566326530612,36.35866593767086,2477,4443,55.750618951159126,2013-14
Milwaukee Bucks,2952,6737,548,1553,43.81772302211667,35.28654217643271,2404,5184,46.373456790123456,2013-14
Minnesota Timberwolves,3189,7175,600,1757,44.44599303135888,34.14911781445646,2589,5418,47.78516057585825,2013-14
New Orleans Pelicans,3101,6761,486,1303,45.86599615441503,37.29854182655411,2615,5458,47.91132282887504,2013-14
New York Knicks,3027,6739,759,2038,44.91764356729485,37.24239450441609,2268,4701,48.245054243777915,2013-14
Oklahoma City Thunder,3194,6782,664,1839,47.095252138012384,36.10657966286025,2530,4943,51.183491806595185,2013-14
Orlando Magic,3022,6784,563,1596,44.54599056603774,35.27568922305765,2459,5188,47.397841171935234,2013-14
Philadelphia 76ers,3108,7150,577,1847,43.46853146853147,31.23984840281538,2531,5303,47.72770130115029,2013-14
Phoenix Suns,3172,6845,765,2055,46.34039444850256,37.22627737226277,2407,4790,50.25052192066806,2013-14
Portland Trail Blazers,3207,7134,770,2071,44.95374264087468,37.18010622887494,2437,5063,48.13351767726644,2013-14
Sacramento Kings,3026,6766,491,1475,44.72361809045226,33.28813559322034,2535,5291,47.91154791154791,2013-14
San Antonio Spurs,3326,6844,698,1757,48.59731151373466,39.72680705748435,2628,5087,51.661096913701584,2013-14
Toronto Raptors,2992,6718,713,1917,44.537064602560285,37.19353155972874,2279,4801,47.4692772339096,2013-14
Utah Jazz,2951,6652,543,1577,44.36259771497294,34.43246670894103,2408,5075,47.44827586206897,2013-14
Washington Wizards,3177,6920,647,1704,45.910404624277454,37.96948356807512,2530,5216,48.50460122699386,2013-14
Atlanta Hawks,3121,6699,818,2152,46.58904314076728,38.01115241635687,2303,4547,50.6487794149989,2014-15
Boston Celtics,3193,7211,660,2021,44.27957287477465,32.6571004453241,2533,5190,48.80539499036609,2014-15
Brooklyn Nets,3069,6804,541,1633,45.10582010582011,33.12921004286589,2528,5171,48.88802939470121,2014-15
Charlotte Hornets,2913,6932,498,1566,42.02250432775534,31.800766283524908,2415,5366,45.005590756615725,2014-15
Chicago Bulls,3001,6797,645,1825,44.15183169045167,35.342465753424655,2356,4972,47.38535800482703,2014-15
Cleveland Cavaliers,3089,6739,826,2253,45.83766137409111,36.66222814025743,2263,4486,50.445831475702185,2014-15
Dallas Mavericks,3255,7036,732,2082,46.26208072768618,35.158501440922194,2523,4954,50.92854259184497,2014-15
Denver Nuggets,3099,7158,660,2032,43.29421626152556,32.48031496062992,2439,5126,47.58095981271947,2014-15
Detroit Pistons,3041,7038,703,2043,43.208297811878374,34.41018110621635,2338,4995,46.806806806806804,2014-15
Golden State Warriors,3410,7137,883,2217,47.779178926719915,39.82859720342805,2527,4920,51.361788617886184,2014-15
Houston Rockets,3032,6832,933,2680,44.37939110070258,34.8134328358209,2099,4152,50.553949903660886,2014-15
Indiana Pacers,2998,6824,612,1740,43.93317702227433,35.172413793103445,2386,5084,46.931549960660895,2014-15
Los Angeles Clippers,3228,6830,827,2202,47.26207906295754,37.55676657584014,2401,4628,51.879861711322384,2014-15
Los Angeles Lakers,3054,7020,532,1546,43.504273504273506,34.411384217335055,2522,5474,46.07234198027037,2014-15
Memphis Grizzlies,3097,6763,423,1246,45.7932870028094,33.94863563402889,2674,5517,48.46837049120899,2014-15
Miami Heat,2885,6330,556,1659,45.57661927330174,33.51416515973478,2329,4671,49.860843502462,2014-15
Milwaukee Bucks,3083,6722,545,1500,45.86432609342457,36.333333333333336,2538,5222,48.60206817311375,2014-15
Minnesota Timberwolves,2986,6820,406,1223,43.78299120234604,33.19705641864268,2580,5597,46.09612292299446,2014-15
New Orleans Pelicans,3108,6795,586,1583,45.73951434878587,37.018319646241316,2522,5212,48.38833461243285,2014-15
New York Knicks,2882,6726,560,1614,42.84864704133214,34.696406443618336,2322,5112,45.42253521126761,2014-15
Oklahoma City Thunder,3184,7119,632,1864,44.725382778480125,33.90557939914164,2552,5255,48.56327307326356,2014-15
Orlando Magic,3076,6792,554,1598,45.28857479387515,34.668335419274094,2522,5194,48.55602618405853,2014-15
Philadelphia 76ers,2765,6777,692,2160,40.79976390733363,32.03703703703704,2073,4617,44.89928525016244,2014-15
Phoenix Suns,3178,7038,698,2048,45.15487354362035,34.08203125,2480,4990,49.69939879759519,2014-15
Portland Trail Blazers,3175,7049,807,2231,45.04184990778834,36.17212012550426,2368,4818,49.149024491490245,2014-15
Sacramento Kings,3010,6617,461,1350,45.48889224724195,34.14814814814815,2549,5267,48.39567116005316,2014-15
San Antonio Spurs,3208,6854,677,1847,46.80478552669974,36.65403356794803,2531,5007,50.54923107649291,2014-15
Toronto Raptors,3108,6829,726,2060,45.51178796309855,35.24271844660194,2382,4769,49.94757810861816,2014-15
Utah Jazz,2900,6492,610,1781,44.670363524337645,34.25042111173498,2290,4711,48.60963701974103,2014-15
Washington Wizards,3139,6790,497,1381,46.22974963181149,35.98841419261405,2642,5409,48.844518395267144,2014-15
Atlanta Hawks,3168,6923,815,2326,45.76050845009389,35.03869303525365,2353,4597,51.185555797259084,2015-16
Boston Celtics,3216,7318,717,2142,43.94643345176278,33.47338935574229,2499,5176,48.2805255023184,2015-16
Brooklyn Nets,3136,6920,531,1508,45.31791907514451,35.212201591511935,2605,5412,48.13377679231338,2015-16
Charlotte Hornets,3036,6922,873,2410,43.86015602427044,36.22406639004149,2163,4512,47.93882978723404,2015-16
Chicago Bulls,3165,7170,651,1753,44.14225941422594,37.13633770678836,2514,5417,46.40945172604763,2015-16
Cleveland Cavaliers,3171,6888,880,2428,46.03658536585366,36.24382207578254,2291,4460,51.36771300448431,2015-16
Dallas Mavericks,3064,6900,806,2342,44.405797101449274,34.415029888983774,2258,4558,49.53927161035542,2015-16
Denver Nuggets,3093,7003,656,1943,44.166785663287165,33.762223365928975,2437,5060,48.162055335968375,2015-16
Detroit Pistons,3111,7087,740,2148,43.8972767038239,34.45065176908753,2371,4939,48.005669163798345,2015-16
Golden State Warriors,3489,7159,1077,2592,48.735856963263025,41.550925925925924,2412,4567,52.81366323626012,2015-16
Houston Rockets,3094,6847,878,2533,45.18767343362056,34.662455586261345,2216,4314,51.36764024107556,2015-16
Indiana Pacers,3142,6985,663,1889,44.982104509663564,35.09793541556379,2479,5096,48.64599686028257,2015-16
LA Clippers,3141,6759,797,2190,46.47137150466045,36.39269406392694,2344,4569,51.30225432260889,2015-16
Los Angeles Lakers,2880,6956,639,2016,41.403105232892464,31.69642857142857,2241,4940,45.364372469635626,2015-16
Memphis Grizzlies,3019,6859,504,1521,44.01516256013996,33.13609467455622,2515,5338,47.11502435369052,2015-16
Miami Heat,3150,6697,498,1480,47.035986262505595,33.648648648648646,2652,5217,50.83381253594019,2015-16
Milwaukee Bucks,3145,6740,440,1277,46.66172106824926,34.455755677368835,2705,5463,49.51491854292514,2015-16
Minnesota Timberwolves,3095,6668,455,1347,46.41571685662868,33.778767631774315,2640,5321,49.61473407254275,2015-16
New Orleans Pelicans,3153,7040,702,1951,44.78693181818182,35.981547924141466,2451,5089,48.16270387109452,2015-16
New York Knicks,3022,6886,610,1762,43.886145803078705,34.61975028376845,2412,5124,47.07259953161593,2015-16
Oklahoma City Thunder,3372,7082,678,1945,47.61366845523863,34.8586118251928,2694,5137,52.443060151839596,2015-16
Orlando Magic,3242,7120,636,1818,45.53370786516854,34.98349834983499,2606,5302,49.15126367408525,2015-16
Philadelphia 76ers,2970,6887,764,2255,43.12472774793088,33.88026607538803,2206,4632,47.62521588946459,2015-16
Phoenix Suns,3051,7018,738,2118,43.47392419492733,34.844192634560905,2313,4900,47.20408163265306,2015-16
Portland Trail Blazers,3167,7040,864,2336,44.98579545454545,36.986301369863014,2303,4704,48.95833333333333,2015-16
Sacramento Kings,3283,7083,660,1839,46.350416490187776,35.88907014681892,2623,5244,50.019069412662084,2015-16
San Antonio Spurs,3289,6797,570,1518,48.388995144916876,37.54940711462451,2719,5279,51.505967039211974,2015-16
Toronto Raptors,3006,6669,708,1915,45.07422402159244,36.97127937336815,2298,4754,48.33824148085822,2015-16
Utah Jazz,2957,6593,694,1956,44.850599120279085,35.48057259713702,2263,4637,48.80310545611387,2015-16
Washington Wizards,3238,7033,709,1983,46.04009668704678,35.75390821986888,2529,5050,50.07920792079208,2015-16
Atlanta Hawks,3123,6918,729,2137,45.143104943625325,34.1132428638278,2394,4781,50.07320644216691,2016-17
Boston Celtics,3168,6977,985,2741,45.406335101046295,35.93578985771616,2183,4236,51.53446647780925,2016-17
Brooklyn Nets,3102,6987,877,2591,44.39673679690854,33.84793516016982,2225,4396,50.614194722474984,2016-17
Charlotte Hornets,3093,7000,824,2347,44.18571428571428,35.10864933958245,2269,4653,48.76423812594025,2016-17
Chicago Bulls,3169,7141,623,1831,44.377538159921585,34.02512288367013,2546,5310,47.94726930320151,2016-17
Cleveland Cavaliers,3275,6963,1067,2779,47.03432428550912,38.39510615329255,2208,4184,52.77246653919694,2016-17
Dallas Mavericks,2968,6750,878,2473,43.97037037037037,35.50343712090579,2090,4277,48.866027589431845,2016-17
Denver Nuggets,3377,7194,870,2365,46.94189602446483,36.78646934460888,2507,4829,51.91551045765169,2016-17
Detroit Pistons,3269,7282,631,1915,44.89151332051634,32.95039164490861,2638,5367,49.15222656977827,2016-17
Golden State Warriors,3532,7140,982,2562,49.46778711484594,38.32943013270882,2550,4578,55.70117955439057,2016-17
Houston Rockets,3305,7152,1181,3306,46.21085011185682,35.72292800967937,2124,3846,55.22620904836193,2016-17
Indiana Pacers,3221,6931,709,1885,46.47237050930602,37.61273209549071,2512,5046,49.78200554894966,2016-17
LA Clippers,3242,6820,841,2245,47.536656891495596,37.46102449888642,2401,4575,52.4808743169399,2016-17
Los Angeles Lakers,3224,7164,730,2110,45.00279173646008,34.59715639810427,2494,5054,49.34705184012663,2016-17
Memphis Grizzlies,2984,6854,767,2169,43.536620951269335,35.361917934532045,2217,4685,47.32123799359658,2016-17
Miami Heat,3202,7037,808,2213,45.50234474918289,36.51152281970177,2394,4824,49.62686567164179,2016-17
Milwaukee Bucks,3182,6715,720,1946,47.386448250186156,36.99897225077081,2462,4769,51.625078632837074,2016-17
Minnesota Timberwolves,3235,6922,601,1723,46.73504767408264,34.881021474172954,2634,5199,50.66358915175996,2016-17
New Orleans Pelicans,3210,7130,768,2196,45.02103786816269,34.97267759562842,2442,4934,49.49331171463316,2016-17
New York Knicks,3244,7256,704,2022,44.707828004410146,34.817012858555884,2540,5234,48.528849828047385,2016-17
Oklahoma City Thunder,3237,7169,692,2116,45.15274096805691,32.70321361058601,2545,5053,50.36611913714625,2016-17
Orlando Magic,3139,7133,701,2139,44.00672928641525,32.77232351566152,2438,4994,48.818582298758514,2016-17
Philadelphia 76ers,3088,6992,831,2443,44.16475972540046,34.01555464592714,2257,4549,49.61530006594856,2016-17
Phoenix Suns,3270,7260,615,1854,45.04132231404959,33.17152103559871,2655,5406,49.112097669256386,2016-17
Portland Trail Blazers,3243,7059,852,2272,45.94135146621334,37.5,2391,4787,49.947775224566534,2016-17
Sacramento Kings,3105,6734,737,1960,46.10929610929611,37.60204081632653,2368,4774,49.602010892333475,2016-17
San Antonio Spurs,3222,6864,753,1927,46.94055944055944,39.07628437986507,2469,4937,50.010127607859026,2016-17
Toronto Raptors,3211,6918,725,1996,46.415148886961546,36.322645290581164,2486,4922,50.50792360828932,2016-17
Utah Jazz,3033,6515,791,2128,46.554105909439755,37.17105263157895,2242,4387,51.10553909277411,2016-17
Washington Wizards,3388,7137,756,2030,47.47092615945075,37.24137931034483,2632,5107,51.53710593303309,2016-17
Atlanta Hawks,3130,7015,917,2544,44.61867426942266,36.04559748427673,2213,4471,49.496756877656004,2017-18
Boston Celtics,3141,6975,939,2492,45.03225806451613,37.68057784911718,2202,4483,49.118893598037026,2017-18
Brooklyn Nets,3136,7114,1041,2924,44.08209165026708,35.601915184678525,2095,4190,50.0,2017-18
Charlotte Hornets,3197,7106,824,2233,44.990149169715735,36.90103000447828,2373,4873,48.696901292838085,2017-18
Chicago Bulls,3170,7285,906,2549,43.51407000686342,35.543350333464105,2264,4736,47.80405405405405,2017-18
Cleveland Cavaliers,3311,6950,981,2636,47.64028776978417,37.2154779969651,2330,4314,54.010199350950394,2017-18
Dallas Mavericks,3128,7042,967,2688,44.419199091167286,35.97470238095239,2161,4354,49.63252181901699,2017-18
Denver Nuggets,3338,7102,940,2536,47.000844832441565,37.06624605678234,2398,4566,52.51861585632939,2017-18
Detroit Pistons,3208,7129,886,2373,44.999298639360354,37.336704593341764,2322,4756,48.82253994953742,2017-18
Golden State Warriors,3509,6979,926,2369,50.27940965754406,39.08822287885184,2583,4610,56.03036876355748,2017-18
Houston Rockets,3174,6906,1256,3470,45.96003475238923,36.195965417867434,1918,3436,55.820721769499414,2017-18
Indiana Pacers,3345,7083,741,2010,47.22575180008471,36.86567164179104,2604,5073,51.33057362507392,2017-18
LA Clippers,3302,7004,777,2196,47.14448886350657,35.38251366120219,2525,4808,52.51663893510815,2017-18
Los Angeles Lakers,3338,7248,822,2384,46.054083885209714,34.47986577181208,2516,4864,51.726973684210535,2017-18
Memphis Grizzlies,3013,6788,758,2152,44.38715380082498,35.22304832713755,2255,4636,48.641069887834334,2017-18
Miami Heat,3184,6997,903,2506,45.5052165213663,36.03351955307262,2281,4491,50.79046982854598,2017-18
Milwaukee Bucks,3257,6807,718,2024,47.84780373145291,35.47430830039526,2539,4783,53.08383859502405,2017-18
Minnesota Timberwolves,3365,7063,658,1845,47.642644768511964,35.66395663956639,2707,5218,51.87811422000767,2017-18
New Orleans Pelicans,3500,7241,837,2312,48.3358652119873,36.202422145328725,2663,4929,54.02718604179346,2017-18
New York Knicks,3334,7193,673,1914,46.35061865702767,35.1619644723093,2661,5279,50.40727410494412,2017-18
Oklahoma City Thunder,3271,7221,881,2491,45.2984351197895,35.367322360497795,2390,4730,50.52854122621564,2017-18
Orlando Magic,3182,7042,844,2405,45.18602669696109,35.093555093555096,2338,4637,50.42053051541945,2017-18
Philadelphia 76ers,3349,7098,901,2445,47.18230487461257,36.85071574642127,2448,4653,52.61121856866537,2017-18
Phoenix Suns,3153,7141,763,2286,44.15347990477524,33.37707786526684,2390,4855,49.22760041194645,2017-18
Portland Trail Blazers,3222,7132,845,2308,45.17666853617499,36.61178509532063,2377,4824,49.27446102819238,2017-18
Sacramento Kings,3179,7063,738,1967,45.00920288829109,37.51906456532791,2441,5096,47.90031397174254,2017-18
San Antonio Spurs,3202,6999,696,1977,45.74939277039577,35.204855842185125,2506,5022,49.90043807248109,2017-18
Toronto Raptors,3383,7169,968,2705,47.189287208815735,35.785582255083185,2415,4464,54.0994623655914,2017-18
Utah Jazz,3139,6797,887,2425,46.18213917904958,36.577319587628864,2252,4372,51.5096065873742,2017-18
Washington Wizards,3275,7018,814,2173,46.665716728412654,37.45973308789692,2461,4845,50.794633642930854,2017-18
Atlanta Hawks,3392,7524,1067,3034,45.08240297713982,35.16809492419248,2325,4490,51.781737193763924,2018-19
Boston Celtics,3451,7423,1032,2829,46.490637208675736,36.47932131495228,2419,4594,52.655637788419675,2018-19
Brooklyn Nets,3301,7358,1047,2965,44.86273443870617,35.31197301854975,2254,4393,51.30890052356021,2018-19
Charlotte Hornets,3297,7362,977,2783,44.7840260798696,35.106000718648936,2320,4579,50.66608429788163,2018-19
Chicago Bulls,3266,7205,745,2123,45.32963219986121,35.09185115402732,2521,5082,49.60645415190869,2018-19
Cleveland Cavaliers,3189,7184,847,2388,44.39031180400891,35.46901172529313,2342,4796,48.83236030025021,2018-19
Dallas Mavericks,3182,7122,1022,3002,44.67846110643078,34.0439706862092,2160,4120,52.42718446601942,2018-19
Denver Nuggets,3439,7384,903,2571,46.57367280606717,35.12252042007001,2536,4813,52.690629544982336,2018-19
Detroit Pistons,3185,7238,993,2854,44.00386847195358,34.79327259985985,2192,4384,50.0,2018-19
Golden State Warriors,3612,7361,1087,2824,49.06941991577231,38.491501416430594,2525,4537,55.653515538902354,2018-19
Houston Rockets,3218,7163,1323,3721,44.92531062404021,35.55495834453104,1895,3442,55.055200464846024,2018-19
Indiana Pacers,3390,7135,779,2081,47.51226348983882,37.433925997116766,2611,5054,51.66204986149584,2018-19
LA Clippers,3384,7178,821,2118,47.14405126776261,38.76298394711992,2563,5060,50.65217391304348,2018-19
Los Angeles Lakers,3491,7425,847,2541,47.01683501683502,33.33333333333333,2644,4884,54.13595413595414,2018-19
Memphis Grizzlies,3113,6924,811,2368,44.95956094742923,34.248310810810814,2302,4556,50.52677787532923,2018-19
Miami Heat,3251,7218,928,2658,45.04017733444167,34.91346877351392,2323,4560,50.94298245614035,2018-19
Milwaukee Bucks,3555,7471,1105,3134,47.583991433543034,35.25845564773453,2450,4337,56.4906617477519,2018-19
Minnesota Timberwolves,3413,7483,827,2357,45.610049445409594,35.08697496817989,2586,5126,50.44869293796332,2018-19
New Orleans Pelicans,3581,7563,842,2449,47.348935607563135,34.381380155165374,2739,5114,53.558858036761826,2018-19
New York Knicks,3134,7241,823,2421,43.28131473553377,33.99421726559273,2311,4820,47.94605809128631,2018-19
Oklahoma City Thunder,3497,7706,932,2677,45.38022320269919,34.81509152035861,2565,5029,51.00417578047326,2018-19
Orlando Magic,3316,7307,937,2633,45.38114137128781,35.58678313710597,2379,4674,50.898587933247754,2018-19
Philadelphia 76ers,3407,7233,889,2474,47.103553159131756,35.93371059013743,2518,4759,52.910275267913434,2018-19
Phoenix Suns,3289,7164,790,2400,45.91010608598548,32.916666666666664,2499,4764,52.455919395466,2018-19
Portland Trail Blazers,3470,7427,904,2520,46.72142183923522,35.87301587301587,2566,4907,52.29264316282861,2018-19
Sacramento Kings,3541,7637,927,2455,46.36637423071887,37.759674134419555,2614,5182,50.443844075646474,2018-19
San Antonio Spurs,3468,7248,812,2071,47.847682119205295,39.20811202317721,2656,5177,51.303843925053116,2018-19
Toronto Raptors,3460,7305,1015,2771,47.36481861738535,36.62937567665103,2445,4534,53.925893250992495,2018-19
Utah Jazz,3314,7082,993,2789,46.79469076532053,35.60415919684475,2321,4293,54.06475658047986,2018-19
Washington Wizards,3456,7387,930,2731,46.784892378502775,34.053460270963015,2526,4656,54.25257731958762,2018-19
Atlanta Hawks,2723,6067,805,2416,44.88214933245426,33.319536423841065,1918,3651,52.53355245138318,2019-20
Boston Celtics,2971,6448,905,2487,46.076302729528535,36.389223964616,2066,3961,52.15854582176218,2019-20
Brooklyn Nets,2908,6498,941,2746,44.752231455832565,34.2680262199563,1967,3752,52.42537313432835,2019-20
Charlotte Hornets,2425,5586,785,2231,43.41210168277838,35.186015239802785,1640,3355,48.8822652757079,2019-20
Chicago Bulls,2573,5762,793,2282,44.65463380770566,34.750219106047325,1780,3480,51.14942528735632,2019-20
Cleveland Cavaliers,2619,5715,727,2070,45.82677165354331,35.1207729468599,1892,3645,51.906721536351164,2019-20
Dallas Mavericks,3124,6772,1136,3095,46.13112817483756,36.7043618739903,1988,3677,54.065814522708735,2019-20
Denver Nuggets,3069,6488,801,2234,47.302712700369916,35.85496866606983,2268,4254,53.31452750352609,2019-20
Detroit Pistons,2595,5658,791,2157,45.86426299045599,36.671302735280484,1804,3501,51.52813481862325,2019-20
Golden State Warriors,2510,5730,678,2032,43.80453752181501,33.36614173228347,1832,3698,49.54029204975662,2019-20
Houston Rockets,2936,6512,1126,3261,45.08599508599509,34.52928549524686,1810,3251,55.6751768686558,2019-20
Indiana Pacers,3075,6457,743,2046,47.622735016261416,36.31476050830889,2332,4411,52.867830423940156,2019-20
LA Clippers,2992,6425,895,2410,46.56809338521401,37.136929460580916,2097,4015,52.22914072229141,2019-20
Los Angeles Lakers,3006,6269,782,2242,47.95023129685755,34.87957181088314,2224,4027,55.227216290042215,2019-20
Memphis Grizzlies,3106,6634,798,2297,46.819415134157374,34.7409664780148,2308,4337,53.21650910767812,2019-20
Miami Heat,2880,6160,979,2584,46.75324675324675,37.88699690402477,1901,3576,53.159955257270695,2019-20
Milwaukee Bucks,3160,6638,1007,2840,47.6047002109069,35.45774647887324,2153,3798,56.68773038441285,2019-20
Minnesota Timberwolves,2586,5865,853,2540,44.092071611253196,33.58267716535433,1733,3325,52.1203007518797,2019-20
New Orleans Pelicans,3065,6598,982,2656,46.45347074871173,36.97289156626506,2083,3942,52.84119736174531,2019-20
New York Knicks,2638,5896,631,1872,44.74219810040705,33.70726495726496,2007,4024,49.87574552683897,2019-20
Oklahoma City Thunder,2879,6156,770,2171,46.76738141650422,35.46752648549056,2109,3985,52.923462986198246,2019-20
Orlando Magic,2871,6468,807,2354,44.38775510204081,34.282073067119796,2064,4114,50.170150704910064,2019-20
Philadelphia 76ers,3000,6417,848,2307,46.75081813931744,36.75769397485912,2152,4110,52.360097323600975,2019-20
Phoenix Suns,3006,6429,831,2320,46.75688287447504,35.81896551724138,2175,4109,52.932587004137254,2019-20
Portland Trail Blazers,3122,6749,952,2525,46.258704993332344,37.7029702970297,2170,4224,51.373106060606055,2019-20
Sacramento Kings,2943,6364,914,2511,46.24450031426775,36.399840700915966,2029,3853,52.66026472878277,2019-20
San Antonio Spurs,2995,6350,760,2021,47.16535433070866,37.6051459673429,2235,4329,51.628551628551634,2019-20
Toronto Raptors,2897,6331,995,2663,45.758963828779024,37.363875328576796,1902,3668,51.853871319520174,2019-20
Utah Jazz,2886,6130,963,2537,47.07993474714519,37.95821836815136,1923,3593,53.52073476203729,2019-20
Washington Wizards,2990,6544,864,2345,45.69070904645477,36.84434968017057,2126,4199,50.63110264348655,2019-20
Atlanta Hawks,2937,6281,895,2402,46.760070052539405,37.26061615320566,2042,3879,52.642433616911575,2020-21
Boston Celtics,2985,6401,979,2618,46.63333854085299,37.39495798319328,2006,3783,53.02669838752313,2020-21
Brooklyn Nets,3106,6289,1020,2600,49.38782000318015,39.23076923076923,2086,3689,56.54648956356736,2020-21
Charlotte Hornets,2875,6324,985,2666,45.461733080328905,36.94673668417104,1890,3658,51.66757791142701,2020-21
Chicago Bulls,3035,6380,904,2446,47.5705329153605,36.95829926410466,2131,3934,54.168784951703095,2020-21
Cleveland Cavaliers,2778,6175,720,2141,44.987854251012145,33.629145259224664,2058,4034,51.01636093207734,2020-21
Dallas Mavericks,2958,6287,994,2744,47.04946715444568,36.224489795918366,1964,3543,55.43324865932825,2020-21
Denver Nuggets,3114,6422,927,2462,48.48956711304889,37.65231519090171,2187,3960,55.22727272727273,2020-21
Detroit Pistons,2783,6162,832,2370,45.16390782213567,35.105485232067515,1951,3792,51.45042194092827,2020-21
Golden State Warriors,2973,6347,1048,2789,46.8410272569718,37.57619218357834,1925,3558,54.10342889263631,2020-21
Houston Rockets,2826,6372,992,2923,44.35028248587571,33.93773520355799,1834,3449,53.174833285010145,2020-21
Indiana Pacers,3115,6567,889,2445,47.434140398964516,36.359918200409,2226,4122,54.00291120815138,2020-21
LA Clippers,3009,6242,1027,2498,48.205703300224286,41.1128903122498,1982,3744,52.93803418803419,2020-21
Los Angeles Lakers,2925,6197,796,2248,47.20025818944651,35.40925266903915,2129,3949,53.91238288174222,2020-21
Memphis Grizzlies,3085,6608,803,2258,46.68583535108959,35.56244464127546,2282,4350,52.45977011494253,2020-21
Miami Heat,2824,6029,932,2606,46.840272018576876,35.76362240982348,1892,3423,55.27315220566754,2020-21
Milwaukee Bucks,3221,6610,1038,2669,48.72919818456884,38.890970400899214,2183,3941,55.39203247906622,2020-21
Minnesota Timberwolves,2932,6546,944,2706,44.79071188512068,34.88543976348855,1988,3840,51.770833333333336,2020-21
New Orleans Pelicans,3060,6412,762,2190,47.72301933873987,34.794520547945204,2298,4222,54.42918048318332,2020-21
New York Knicks,2839,6225,847,2163,45.606425702811244,39.15857605177994,1992,4062,49.039881831610046,2020-21
Oklahoma City Thunder,2795,6338,857,2529,44.09908488482171,33.886911822854884,1938,3809,50.87949593069047,2020-21
Orlando Magic,2754,6423,784,2288,42.877160205511444,34.26573426573427,1970,4135,47.64207980652962,2020-21
Philadelphia 76ers,2981,6257,811,2169,47.64264024292792,37.390502535730754,2170,4088,53.082191780821915,2020-21
Phoenix Suns,3118,6357,940,2490,49.04829322007236,37.75100401606426,2178,3867,56.32273079906904,2020-21
Portland Trail Blazers,2973,6558,1132,2939,45.33394327538884,38.51650221163661,1841,3619,50.870406189555126,2020-21
Sacramento Kings,3067,6382,874,2400,48.057035412096525,36.41666666666667,2193,3982,55.07282772476143,2020-21
San Antonio Spurs,3014,6518,716,2046,46.24117827554465,34.99511241446726,2298,4472,51.38640429338104,2020-21
Toronto Raptors,2859,6383,1041,2831,44.790850697164345,36.77145884846344,1818,3552,51.182432432432435,2020-21
Utah Jazz,2971,6344,1205,3098,46.831651954602776,38.896061975468044,1766,3246,54.40542205791744,2020-21
Washington Wizards,3108,6547,733,2088,47.47212463723843,35.105363984674334,2375,4459,53.2630634671451,2020-21
Atlanta Hawks,3401,7241,1056,2821,46.968650738848226,37.43353420772776,2345,4420,53.05429864253394,2021-22
Boston Celtics,3341,7167,1085,3044,46.61643644481652,35.64388961892247,2256,4123,54.717438758185786,2021-22
Brooklyn Nets,3442,7251,940,2602,47.469314577299684,36.1260568793236,2502,4649,53.818025381802535,2021-22
Charlotte Hornets,3508,7497,1143,3130,46.79205015339469,36.51757188498402,2365,4367,54.15617128463476,2021-22
Chicago Bulls,3422,7127,872,2364,48.01459239511716,36.88663282571912,2550,4763,53.53768633214361,2021-22
Cleveland Cavaliers,3255,6940,953,2686,46.90201729106629,35.48026805658972,2302,4254,54.11377527033381,2021-22
Dallas Mavericks,3222,6982,1073,3063,46.14723574906903,35.03101534443356,2149,3919,54.83541719826487,2021-22
Denver Nuggets,3416,7079,1039,2944,48.25540330555163,35.29211956521739,2377,4135,57.48488512696493,2021-22
Detroit Pistons,3129,7267,925,2838,43.057657905600664,32.593375616631434,2204,4429,49.762926168435314,2021-22
Golden State Warriors,3323,7087,1176,3231,46.88866939466629,36.397400185701024,2147,3856,55.67946058091287,2021-22
Houston Rockets,3229,7083,1105,3170,45.588027671890444,34.85804416403786,2124,3913,54.28060311781242,2021-22
Indiana Pacers,3398,7338,997,2899,46.30689561188335,34.39116936874784,2401,4439,54.08875872944356,2021-22
LA Clippers,3285,7170,1047,2802,45.81589958158996,37.3661670235546,2238,4368,51.23626373626373,2021-22
Los Angeles Lakers,3415,7279,982,2826,46.91578513532079,34.74876150035386,2433,4453,54.637323152930605,2021-22
Memphis Grizzlies,3571,7739,945,2679,46.14291252099754,35.27435610302352,2626,5060,51.89723320158103,2021-22
Miami Heat,3246,6954,1114,2936,46.67817083692839,37.94277929155314,2132,4018,53.06122448979592,2021-22
Milwaukee Bucks,3429,7331,1153,3151,46.773973537034514,36.5915582354808,2276,4180,54.44976076555024,2021-22
Minnesota Timberwolves,3411,7458,1211,3386,45.73612228479485,35.76491435321913,2200,4072,54.02750491159135,2021-22
New Orleans Pelicans,3294,7212,873,2629,45.673876871880196,33.20654241156333,2421,4583,52.825660048003485,2021-22
New York Knicks,3088,7069,1082,3029,43.68368934785684,35.721360184879494,2006,4040,49.65346534653465,2021-22
Oklahoma City Thunder,3141,7310,991,3066,42.968536251709985,32.32224396607958,2150,4244,50.6597549481621,2021-22
Orlando Magic,3139,7240,999,3022,43.35635359116022,33.05757776307082,2140,4218,50.734945471787576,2021-22
Philadelphia 76ers,3230,6932,950,2608,46.59549913444893,36.42638036809816,2280,4324,52.72895467160037,2021-22
Phoenix Suns,3581,7389,951,2616,48.463932873189876,36.353211009174316,2630,4773,55.10161324114813,2021-22
Portland Trail Blazers,3161,7144,1043,3017,44.246920492721166,34.5707656612529,2118,4127,51.32057184395444,2021-22
Sacramento Kings,3321,7223,937,2722,45.97812543264572,34.42321822189566,2384,4501,52.96600755387691,2021-22
San Antonio Spurs,3546,7601,925,2626,46.651756347848966,35.224676313785224,2621,4975,52.68341708542713,2021-22
Toronto Raptors,3332,7489,979,2808,44.49192148484444,34.864672364672366,2353,4681,50.26703695791498,2021-22
Utah Jazz,3327,7067,1192,3308,47.077968020376396,36.03385731559855,2135,3759,56.79702048417133,2021-22
Washington Wizards,3327,7056,860,2512,47.15136054421769,34.23566878980891,2467,4544,54.29137323943662,2021-22
Atlanta Hawks,3658,7574,882,2505,48.29680485872723,35.20958083832335,2776,5069,54.76425330439929,2022-23
Boston Celtics,3460,7278,1315,3492,47.540533113492714,37.65750286368843,2145,3786,56.65610142630745,2022-23
Brooklyn Nets,3399,6978,1048,2771,48.71023215821152,37.82028148682786,2351,4207,55.883052056096986,2022-23
Charlotte Hornets,3385,7413,881,2669,45.6630244165655,33.00861745972274,2504,4744,52.78246205733558,2022-23
Chicago Bulls,3488,7116,854,2367,49.01630129286116,36.0794254330376,2634,4749,55.46430827542641,2022-23
Cleveland Cavaliers,3408,6984,950,2589,48.797250859106526,36.69370413286984,2458,4395,55.92718998862344,2022-23
Dallas Mavericks,3283,6909,1246,3362,47.5177304964539,37.06127305175491,2037,3547,57.4288130814773,2022-23
Denver Nuggets,3574,7088,969,2559,50.42325056433409,37.86635404454865,2605,4529,57.51821594170898,2022-23
Detroit Pistons,3244,7140,934,2659,45.43417366946779,35.125987213238055,2310,4481,51.55099308190137,2022-23
Golden State Warriors,3538,7393,1363,3540,47.85608007574733,38.50282485875706,2175,3853,56.4495198546587,2022-23
Houston Rockets,3329,7287,856,2619,45.68409496363387,32.684230622374955,2473,4668,52.9777206512425,2022-23
Indiana Pacers,3444,7345,1112,3030,46.88904016337644,36.6996699669967,2332,4315,54.04403244495944,2022-23
LA Clippers,3370,7060,1041,2734,47.73371104815864,38.0760790051207,2329,4326,53.837263060564034,2022-23
Los Angeles Lakers,3516,7298,885,2558,48.1775828994245,34.59734167318217,2631,4740,55.506329113924046,2022-23
Memphis Grizzlies,3585,7551,985,2807,47.47715534366309,35.090844317776984,2600,4744,54.80607082630692,2022-23
Miami Heat,3215,6991,980,2852,45.98769846946074,34.36185133239832,2235,4139,53.998550374486584,2022-23
Milwaukee Bucks,3504,7411,1217,3306,47.28106868168938,36.8118572292801,2287,4105,55.71254567600488,2022-23
Minnesota Timberwolves,3515,7167,997,2731,49.044230500906934,36.50677407543024,2518,4436,56.762849413886386,2022-23
New Orleans Pelicans,3447,7180,899,2468,48.008356545961,36.426256077795784,2548,4712,54.074702886247884,2022-23
New York Knicks,3444,7328,1037,2930,46.99781659388647,35.39249146757679,2407,4398,54.7294224647567,2022-23
Oklahoma City Thunder,3533,7590,995,2797,46.54808959156785,35.57382910260994,2538,4793,52.95222199040267,2022-23
Orlando Magic,3323,7074,883,2551,46.9748374328527,34.61387691101529,2440,4523,53.94649568870219,2022-23
Philadelphia 76ers,3347,6870,1035,2675,48.71906841339156,38.691588785046726,2312,4195,55.11323003575686,2022-23
Phoenix Suns,3453,7388,1001,2674,46.73795343800758,37.43455497382199,2452,4714,52.015273652948665,2022-23
Portland Trail Blazers,3317,7001,1056,2893,47.37894586487645,36.50190114068441,2261,4108,55.038948393378774,2022-23
Sacramento Kings,3573,7232,1128,3060,49.4054203539823,36.86274509803922,2445,4172,58.604985618408435,2022-23
San Antonio Spurs,3533,7593,911,2640,46.529698406426974,34.50757575757576,2622,4953,52.937613567534825,2022-23
Toronto Raptors,3434,7489,880,2626,45.85391908131927,33.51104341203351,2554,4863,52.519021180341355,2022-23
Utah Jazz,3485,7365,1094,3099,47.3183978275628,35.30171022910616,2391,4266,56.0478199718706,2022-23
Washington Wizards,3456,7127,925,2601,48.491651466255085,35.563244905805455,2531,4526,55.92134334953601,2022-23
Atlanta Hawks,3529,7584,1125,3092,46.53217299578059,36.38421733505822,2404,4492,53.517364203027604,2023-24
Boston Celtics,3601,7396,1351,3482,48.68848025959978,38.79954049396898,2250,3914,57.48594787940725,2023-24
Brooklyn Nets,3334,7307,1089,3010,45.62748049815246,36.179401993355484,2245,4297,52.24575285082616,2023-24
Charlotte Hornets,3281,7133,989,2788,45.99747651759428,35.47345767575323,2292,4345,52.75028768699654,2023-24
Chicago Bulls,3448,7339,941,2630,46.98187764000545,35.77946768060836,2507,4709,53.238479507326396,2023-24
Cleveland Cavaliers,3425,7148,1108,3016,47.915500839395634,36.737400530503976,2317,4132,56.074540174249755,2023-24
Dallas Mavericks,3535,7352,1197,3242,48.08215451577802,36.921653300431835,2338,4110,56.885644768856444,2023-24
Denver Nuggets,3610,7279,958,2560,49.59472455007556,37.421875,2652,4719,56.19834710743802,2023-24
Detroit Pistons,3353,7236,906,2602,46.33775566611387,34.81936971560338,2447,4634,52.805351747949935,2023-24
Golden State Warriors,3582,7515,1211,3191,47.66467065868263,37.95048574114698,2371,4324,54.83348751156337,2023-24
Houston Rockets,3425,7459,1043,2964,45.91768333556777,35.1889338731444,2382,4495,52.992213570634036,2023-24
Indiana Pacers,3855,7599,1082,2891,50.730359257797076,37.42649602213767,2773,4708,58.89974511469839,2023-24
LA Clippers,3473,7108,1036,2719,48.86043894203714,38.102243471864654,2437,4389,55.52517657780815,2023-24
Los Angeles Lakers,3580,7177,969,2572,49.881566113975204,37.67496111975117,2611,4605,56.699239956568945,2023-24
Memphis Grizzlies,3145,7229,1071,3097,43.50532577119934,34.58185340652244,2074,4132,50.19361084220716,2023-24
Miami Heat,3266,7022,1022,2765,46.51096553688408,36.9620253164557,2244,4257,52.71317829457365,2023-24
Milwaukee Bucks,3538,7258,1163,3122,48.7462110774318,37.25176169122357,2375,4136,57.42263056092843,2023-24
Minnesota Timberwolves,3383,6974,1037,2681,48.508746773731,38.67959716523685,2346,4293,54.647099930118806,2023-24
New Orleans Pelicans,3484,7165,1023,2673,48.62526168876483,38.2716049382716,2461,4492,54.78628673196795,2023-24
New York Knicks,3385,7272,1083,2936,46.54840484048405,36.88692098092643,2302,4336,53.09040590405905,2023-24
Oklahoma City Thunder,3653,7324,1090,2805,49.87711632987439,38.859180035650624,2563,4519,56.71608763000664,2023-24
Orlando Magic,3318,6964,903,2568,47.64503159103963,35.16355140186916,2415,4396,54.93630573248408,2023-24
Philadelphia 76ers,3404,7331,992,2733,46.43295594052653,36.2971094035858,2412,4598,52.457590256633324,2023-24
Phoenix Suns,3482,7063,1020,2671,49.299164660908964,38.187944590041184,2462,4392,56.056466302367944,2023-24
Portland Trail Blazers,3227,7356,939,2723,43.868950516585095,34.48402497245685,2288,4633,49.384847830779194,2023-24
Sacramento Kings,3553,7455,1178,3219,47.65928906773978,36.595215905560735,2375,4236,56.06704438149197,2023-24
San Antonio Spurs,3438,7436,1036,2983,46.23453469607316,34.73013744552464,2402,4453,53.941163260723116,2023-24
Toronto Raptors,3466,7356,942,2712,47.11799891245242,34.73451327433628,2524,4644,54.34969853574505,2023-24
Utah Jazz,3443,7371,1060,2993,46.71008004341338,35.415970598062145,2383,4378,54.43124714481499,2023-24
Washington Wizards,3523,7493,1015,2915,47.01721606833044,34.81989708404803,2508,4578,54.78374836173001,2023-24
